Mr.	mister
Mrs.	misses
Dr.	doctor
Drs.	doctors
Co.	company
Lt.	lieutenant
Sgt.	sergeant
St.	saint
Jr.	junior
Maj.	major
Hon.	honorable
Gov.	governor
Capt.	captain
Esq.	esquire
Gen.	general
Ltd.	limited
Rev.	reverend
Col.	colonel
Mt.	mount
Ft.	fort
Tenn.	tennessee
vs.	versus
&	and
ยง	section
#	hash
=	equals
