O 2 O	O to O
O2O	O to O
P 2 P	P to P
P2P	P to P
CD	C D
a.m.	a m
am.	a m
AM	a m
Am	a m
 am 	a m
p.m.	p m
pm.	p m
Pm	p m
 pm 	p m
atm 	A T M
ATM	A T M
Atm	A T M
ufo	U F O
Ufo	U F O
UFO	U F O
u f o	U F O
m v	M V
mv	M V
MV	M V
F I F A	FIFA
f i f a	FIFA
fifa	FIFA
nba	N B A
Nba	N B A
NBA	N B A
n b a	N B A
xL	X L
XL	X L
xxL	X X L
XXL	X X L
xxxL	X X X L
XXXL	X X X L
QQ	Q Q
qq	Q Q
Qq	Q Q
gpu	G P U
GPU	G P U
cpu	C P U
C P U	C P U
wifi	WIFI
W I F I	WIFI
ms	MS
ceo	C E O
c e o	C E O
CEO	C E O
dv	D V
d v	D V
DV	D V
wto	W T O
w t o 	W T O
WTO	W T O
pc	P C
p c	P C
PC	P C
gps	G P S
GPS	G P S
M.V.P	M V P
mvp	M V P
MVP	M V P
vip	V I P
VIP	V I P
cba	C B A
c b a	C B A
CBA	C B A
mba	M B A
m b a	M B A
MBA	M B A
iq	I Q
IQ	I Q
EQ	E Q
cctv	C C T V
CCtv	C C T V
kfc	K F C
KFC	K F C
Steam	steam
steam	steam
